NO ./textures/Walls/Wall_1.ppm
SO ./textures/Walls/Wall_2.ppm
WE ./textures/Walls/Wall_3.ppm
EA ./textures/Walls/Wall_4.ppm

F 128,128,128
C 225,30,0

        1111111111111111111111111
        1000000000110000000000001
        1011000001110000000000001
        1001000000000A00L00000011
111111111011000001110000000000001
1000000000000000011111DD110111111
11110111111111011100O00010001
11110111111111011101010010001
110000001101010111000N0010001
10000000000000001100000010001
10000000000000001101010010001
1100000111010101111101111000111
11110111 1110101 101111010001
11111111 1111111 111111111111
