NO ./textures/Walls/Wall_1.ppm
SO ./textures/Walls/Wall_2.ppm
WE ./textures/Walls/Wall_3.ppm
EA ./textures/Walls/Wall_4.ppm

F 128,128,128
C 225,30,0

1111111
1000001
1000001
1N00001
11111001
     1001
      1001
       1001
        101
        101
        101
       1001
      1001
     1001
    1001
11111011
10000001
10000001
10000001
10000001
100000L1
11111111
