NO ./textures/Brick.ppm
SO ./textures/Checkerboard.ppm
WE ./textures/Wall.ppm
EA ./textures/Window.ppm

F 220,100,0
C 225,30,0

11111111
10010001
10000001
11010001
10000001
10000N01
10000001
11111111



