NO ./textures/Walls/Wall_1.ppm
SO ./textures/Walls/Wall_2.ppm
WE ./textures/Walls/Wall_3.ppm
EA ./textures/Walls/Wall_4.ppm

F 128,128,128
C 225,30,0

        1111111111111111111111111
        100000L000110000000000001
        1D11000001110000000000001
        1001000000D0000000000001
111111111011000001110000000000001
10000000001100000111D11111D111111
1111D111111111D11100000010001
11110111111111011101010010001
11000000110101011100000010001
10000000000000001100000010001
10000000000000001101010010001
11000001110101011111011110N0111
11110111 1110101 101111010001
11111111 1111111 111111111111



