33322222
30020002
30040002
22420002
20000002
20000202
20000002
22222222
